+---+---+---+---+---+---+---+---+---+---+---+---+---+---+---+---+
|   |   |       |                   |   |   |                   |
+   +   +   +   +   +---+---+   +   +   +   +---+---+---+   +   +
|   |       |               |   |   |               |       |   |
+   +   +---+   +---+---+---+   +---+---+---+   +   +   +   +   +
|           |   |           |       |           |       |   |   |
+   +---+---+---+---+---+   +   +   +   +   +---+---+---+---+---+
|                           |   |   |   |               |       |
+---+---+---+---+---+---+   +   +   +---+---+---+---+   +---+   +
|       |       |   |       |   |                       |       |
+   +   +   +   +   +   +---+   +   +   +---+---+---+   +   +   +
|   |       |   |       |   |   |   |           |   |       |   |
+---+   +---+   +   +---+   +   +   +   +   +---+   +---+---+---+
|           |           |   |   |   |   |       |               |
+   +---+---+   +---+---+   +---+---+   +   +   +   +---+---+   +
|           |               |       |   |   |               |   |
+---+---+---+   +---+---+---+   G   +   +   +---+---+---+---+   +
|   |                   |   |       |   |       |   |           |
+   +---+---+---+---+   +   +   +   +---+---+---+   +---+---+   +
|               |       |   |   |                   |           |
+---+---+   +---+   +---+   +   +---+---+---+---+   +---+   +   +
|           |           |   |               |               |   |
+---+   +   +---+---+   +   +   +---+---+   +---+---+---+---+   +
|       |   |   |       |   |   |       |   |   |           |   |
+   +---+   +   +   +---+   +   +   +   +   +   +---+   +   +   +
|   |       |               |   |   |   |   |   |       |   |   |
+   +---+---+   +---+---+---+---+   +---+   +   +   +---+---+   +
|                                   |   |   |   |           |   |
+   +---+---+---+   +---+---+---+   +   +   +   +---+   +   +---+
|   |       |       |   |       |   |   |   |   |       |   |   |
+   +   +   +   +---+   +   +   +   +   +---+   +   +   +   +   +
|       |   |       |       |                       |   |   |   |
+---+---+---+---+---+---+---+---+---+---+---+---+---+---+---+---+