+---+---+---+---+---+---+---+---+---+---+---+---+---+---+---+---+
|       |   |       |       |       |       |       |   |       |
+   +   +   +   +   +   +   +   +   +   +   +   +   +   +   +   +
|   |   |       |   |   |   |   |   |   |   |   |   |       |   |
+---+   +   +---+   +   +   +   +   +   +   +   +   +   +---+   +
|   |           |       |       |       |       |           |   |
+   +   +---+---+   +---+---+   +---+---+---+---+---+---+---+   +
|               |       |   |   |                               |
+---+---+---+---+---+---+   +---+---+---+---+---+---+   +---+   +
|               |           |   |           |           |   |   |
+   +---+---+   +---+   +   +   +---+   +   +   +   +---+   +   +
|   |                   |       |       |   |   |   |       |   |
+   +---+---+---+---+---+---+   +   +   +   +---+   +   +   +   +
|           |   |                   |   |       |   |   |       |
+   +---+---+   +---+---+---+---+---+   +---+   +   +---+---+   +
|           |           |           |   |           |       |   |
+   +   +---+   +   +---+   +   G   +---+---+---+---+---+   +   +
|   |       |   |       |   |                           |       |
+   +   +   +   +   +   +   +---+---+---+---+---+   +---+---+---+
|   |   |       |   |       |   |               |   |           |
+   +---+   +---+   +---+---+   +   +---+---+   +   +---+---+   +
|   |   |   |   |   |           |       |       |   |           |
+---+   +---+   +---+   +---+   +   +   +   +---+   +   +   +---+
|   |       |       |   |   |   |   |   |       |   |   |   |   |
+   +   +   +   +   +---+   +   +---+   +---+   +   +   +   +   +
|   |   |       |               |       |           |   |       |
+   +   +---+---+---+---+---+---+   +   +---+---+   +   +---+---+
|   |   |                           |   |               |       |
+   +   +---+---+---+---+---+   +   +   +---+---+---+   +---+   +
|                               |   |   |           |   |       |
+   +---+---+---+   +   +   +   +   +   +   +---+---+   +   +   +
|           |       |   |   |   |   |   |                   |   |
+---+---+---+---+---+---+---+---+---+---+---+---+---+---+---+---+