+---+---+---+---+---+---+---+---+---+---+---+---+---+---+---+---+
|                           |   |               |       |   |   |
+---+---+---+---+   +---+   +   +   +---+---+---+---+   +   +   +
|                   |           |                           |   |
+   +---+---+---+---+---+   +   +   +   +---+---+---+   +   +   +
|               |   |   |   |   |   |       |   |       |   |   |
+   +---+---+   +   +   +---+---+   +   +   +   +---+---+---+   +
|   |       |   |   |               |   |   |                   |
+   +   +   +   +   +   +---+---+---+---+   +   +---+   +---+   +
|   |   |   |   |                   |   |           |   |       |
+   +   +---+   +   +---+---+---+---+   +   +---+   +   +---+   +
|           |               |   |       |   |       |   |       |
+---+---+   +   +---+---+   +   +   +   +   +---+---+   +---+---+
|           |   |   |   |       |   |   |   |           |       |
+---+---+---+   +   +   +---+   +   +---+---+---+   +   +---+   +
|       |   |       |       |       |               |           |
+   +   +   +   +---+   +   +   G   +---+---+   +   +   +---+---+
|   |   |       |   |   |           |           |   |   |       |
+---+   +---+---+   +   +---+---+   +   +---+---+   +   +   +---+
|   |               |       |   |   |           |   |   |       |
+   +   +   +---+   +---+---+   +---+---+---+   +   +   +   +   +
|   |   |   |           |   |   |               |   |   |   |   |
+   +---+   +---+---+   +   +   +   +   +---+   +   +   +---+   +
|           |               |   |   |       |   |   |           |
+---+---+   +---+---+---+   +   +---+---+   +   +   +---+---+   +
|   |   |   |       |           |           |   |   |           |
+   +   +   +   +   +---+---+   +---+   +---+---+   +---+---+   +
|   |   |   |   |           |   |   |           |   |           |
+   +   +---+---+---+---+   +   +   +   +   +---+---+---+---+---+
|                           |   |       |                       |
+   +   +   +---+   +---+---+   +---+---+---+---+---+   +---+   +
|   |   |       |                                       |       |
+---+---+---+---+---+---+---+---+---+---+---+---+---+---+---+---+